+-------------------------------------------------------------------+
|                                                                   |
|                                                                   |
|                                                                   |
+-----------------------------------------------+                   |
|                                               |                   |
|                                               |                   |
|                                               |                   |
|                                               |                   |
|                                               |                   |
+----------------------------+                  |                   |
|                            |                  |                   |
|                            |                  |                   |
|                            |                  |                   |
|                            |                  |                   |
|                            |                  |                   |
|                                                                   |
|                                                                   |
|                                                                   |
|                                                                   |
+-------------------------------------------------------------------+
level
+++++++++++++++++++++++++++++++++++++++++++++++++++++++++++++++++++++
+++++++++++++++++++++++++++++++++++++++++++++++++++++++++++++++++++++
++                                                                 ++
++                                                                 ++
++                                                                 ++
++                                |                                ++
++                                |                                ++
++                                |                                ++
++                                |                                ++
++                                |                                ++
++--------------------------------+        +-----------------------++
++                                         |                       ++
++                                         |                       ++
++                                         |                       ++
++                                         |                       ++
++                                         |                       ++
++                                                                 ++
++                                                                 ++
++                                                                 ++
+++++++++++++++++++++++++++++++++++++++++++++++++++++++++++++++++++++
+++++++++++++++++++++++++++++++++++++++++++++++++++++++++++++++++++++
level
