+-------------------------------------------------------------------+
|                                                                   |
|                                                                   |
|                                                                   |
|                                                                   |
|                                                                   |
|                                    |                              |
|                                    |                              |
|                                    |                              |
+---------------------------         |           -------------------+
|                                    |                              |
|                                    |                              |
|                                                                   |
|                                                                   |
|                                                                   |
|         |                                                         |
|         |                  ---------------------------------------+
|         |                                                         |
|         |                                                         |
|         |                                                         |
+---------+---------------------------------------------------------+
level
+-------------------------------------------------------------------+
|                                                                   |
|                                                                   |
|                                                                   |
|                                                                   |
|                                                                   |
|                                                                   |
|                                                                   |
|                                                                   |
|                                                                   |
|                                                                   |
|                                                                   |
|                                                                   |
|                                                                   |
|                                                                   |
|                                                                   |
|                                                                   |
|                                                                   |
|                                                                   |
|                                                                   |
+-------------------------------------------------------------------+
level
+-------------------------------------------------------------------+
|                                                                   |
|                                                                   |
|                                                                   |
|                                                                   |
|                                                                   |
|                                                                   |
|                                                                   |
|                                                                   |
|                                                                   |
|                                                                   |
|                                                                   |
|                                                                   |
|                                                                   |
|                                                                   |
|                                                                   |
|                                                                   |
|                                                                   |
|                                                                   |
|                                                                   |
+-------------------------------------------------------------------+
level
+-------------------------------------------------------------------+
|                                                                   |
|                                                                   |
|                                                                   |
|                                                                   |
|                                                                   |
|                                                                   |
|                                                                   |
|                                                                   |
|                                                                   |
|                                                                   |
|                                                                   |
|                                                                   |
|                                                                   |
|                                                                   |
|                                                                   |
|                                                                   |
|                                                                   |
|                                                                   |
|                                                                   |
+-------------------------------------------------------------------+
level
+-------------------------------------------------------------------+
|                                                                   |
|                                                                   |
|                                                                   |
|                                                                   |
|                                                                   |
|                                                                   |
|                                                                   |
|                                                                   |
|                                                                   |
|                                                                   |
|                                                                   |
|                                                                   |
|                                                                   |
|                                                                   |
|                                                                   |
|                                                                   |
|                                                                   |
|                                                                   |
|                                                                   |
+-------------------------------------------------------------------+
