+-------------------------------------------------------------------+
|                                                                   |
|                                                                   |
|                                                                   |
+----------------------------                   |                   |
|                                               |                   |
|                                               |                   |
|                                               |                   |
|                                               |                   |
|                                               |                   |
+----------------------------                   |                   |
|                                               |                   |
|                                               |                   |
|                                               |                   |
|                                               |                   |
|                                               |                   |
|                                                                   |
|                                                                   |
|                                                                   |
|                                                                   |
+-------------------------------------------------------------------+
level
+++++++++++++++++++++++++++++++++++++++++++++++++++++++++++++++++++++
+++++++++++++++++++++++++++++++++++++++++++++++++++++++++++++++++++++
++                                                                 ++
++                                                                 ++
++                                                                 ++
++                                |                                ++
++                                |                                ++
++                                |                                ++
++                                |                                ++
++                                |                                ++
++--------------------------------+        +-----------------------++
++                                         |                       ++
++                                         |                       ++
++                                         |                       ++
++                                         |                       ++
++                                         |                       ++
++                                                                 ++
++                                                                 ++
++                                                                 ++
+++++++++++++++++++++++++++++++++++++++++++++++++++++++++++++++++++++
+++++++++++++++++++++++++++++++++++++++++++++++++++++++++++++++++++++
level
+-------------------------------------------------------------------+
|                                                                   |
|                                                                   |
|                 +---------------------------+          |          |
|                 |                           |          |          |
|                 |                           |          |          |
|                 |                           |          |          |
|                 |                           |          |          |
|                                                        |          |
|                                                        |          |
|                                                       ++          |
|                                                       |           |
|                                                       |           |
|                                                       |           |
|                                                       |           |
|                                                       |           |
|                                                       |           |
|                                                       |           |
|                                                       |           |
|                                                       |           |
+-------------------------------------------------------+-----------+
level
+-------------------------------------------------------------------+
|                                                                   |
|                                                                   |
|                                                                   |
|                                                                   |
|                                                                   |
|          ---------------------+                                   |
|                               |                                   |
|                               |                                   |
|                               |                                   |
|                               |                                   |
|                               |                                   |
|                               |                                   |
|                               |                                   |
|                               |                                   |
|                               |                                   |
|                               |                                   |
|                               |                                   |
|   --- --- --- --- --- ---     |                                   |
|                               |                                   |
+-------------------------------+-----------------------------------+
level
+-------------------------------------------------------------------+
|                                                                   |
|                                                                   |
|                                                                   |
+---------------------+                          |                  |
|                     |                          |                  |
|                     |                          |                  |
|                     |                          |                  |
|                     |                          |                  |
|                     |                          |                  |
|                     |                          |                  |
|                     |                          |                  |
|                     +---------+                +------------------+
|                               |                                   |
|                               |                                   |
|                               |                                   |
|                               |                                   |
|                                                                   |
|                                                                   |
|                                                                   |
+-------------------------------------------------------------------+
level
+-------------------------------------------------------------------+
|                                                                   |
|                                                                   |
|                                                                   |
|                                                                   |
|                                                                   |
|                                                                   |
|                                                                   |
|                                                                   |
|                                                                   |
|                                                                   |
|                                                                   |
|                                                                   |
|                                                                   |
|                                                                   |
|                                                                   |
|                                                                   |
|                                                                   |
|                                                                   |
|                                                                   |
+-------------------------------------------------------------------+
level
+-------------------------------------------------------------------+
|                                                                   |
|                                                                   |
|                                                                   |
|                                                                   |
|                                                                   |
|                                                                   |
|                                                                   |
|                                                                   |
|                                                                   |
|                                                                   |
|                                                                   |
|                                                                   |
|                                                                   |
|                                                                   |
|                                                                   |
|                                                                   |
|                                                                   |
|                                                                   |
|                                                                   |
+-------------------------------------------------------------------+
level
+-------------------------------------------------------------------+
|                                                                   |
|                                                                   |
|                                                                   |
|                                                                   |
|                                                                   |
|                                                                   |
|                                                                   |
|                                                                   |
|                                                                   |
|         +--------------------+                                    |
|         |                    |                                    |
|         |                                                         |
|         |                    |                                    |
|         |                    |                                    |
|         +--------------------+                                    |
|                                                                   |
|                                                                   |
|                                                                   |
|                                                                   |
+-------------------------------------------------------------------+
level
+-------------------------------------------------------------------+
|                                                                   |
|                                                                   |
|                                                                   |
|                                                                   |
|                                                                   |
|                                                                   |
|                                                                   |
|                                                                   |
|                                                                   |
|                                                                   |
|                                                                   |
|                                                                   |
|                      |                                            |
|                      |                                            |
|                      |                                            |
|                      |                                            |
|                      |                                            |
|                      |                                            |
|                      |                                            |
+----------------------+--------------------------------------------+
level
