+-------------------------------------------------------------------+
|                                                                   |
|                                                                   |
|                                                                   |
|                                                                   |
|                                                                   |
|                                                                   |
|                                                                   |
|                                                                   |
|                                                                   |
|                                                                   |
|                                                                   |
|                                                                   |
|                                                                   |
|                                                                   |
|                                                                   |
|                                                                   |
|                                                                   |
|                                                                   |
|                                                                   |
+-------------------------------------------------------------------+
map
+-------------------------------------------------------------------+
|                                                                   |
|                                                                   |
|                                                                   |
|                                                                   |
|                                                                   |
|                |               |               |                  |
|                |               |               |                  |
|                |               |               |                  |
|                |               |               |                  |
|                |               |               |                  |
|                |               |               |                  |
|                |               |               |                  |
|                |               |               |                  |
|                |               |               |                  |
|                                                                   |
|                                                                   |
|                                                                   |
|                                                                   |
|                                                                   |
+-------------------------------------------------------------------+
map
+-------------------------------------------------------------------+
|                                                                   |
|                                                                   |
|                                                                   |
|                                                                   |
|                                                                   |
|                +-------------------------------+                  |
|                |                               |                  |
|                |                               |                  |
|                |                               |                  |
|                |                               |                  |
|                |                               |                  |
|                |                               |                  |
|                |                               |                  |
|                +-------+               +-------+                  |
|                                                                   |
|                                                                   |
|                                                                   |
|                                                                   |
|                                                                   |
+-------------------------------------------------------------------+
map



+-------------------------------------------------------------------+
|                                                                   |
|                                                                   |
|                                                                   |
|                                                                   |
|                                                                   |
|                                                                   |
|                                                                   |
|                                                                   |
|                                                                   |
|                                                                   |
|                                                                   |
|                                                                   |
|                                                                   |
|                                                                   |
|                                                                   |
|                                                                   |
|                                                                   |
|                                                                   |
|                                                                   |
+-------------------------------------------------------------------+
map
+-------------------------------------------------------------------+
|                                                                   |
|                                                                   |
|                                                                   |
|                                                                   |
|                                                                   |
|                                                                   |
|                                                                   |
|                                                                   |
|                                                                   |
|                                                                   |
|                                                                   |
|                                                                   |
|                                                                   |
|                                                                   |
|                                                                   |
|                                                                   |
|                                                                   |
|                                                                   |
|                                                                   |
+-------------------------------------------------------------------+
